AAAAAAAAAAAAAAAAAAAAAAAAAAAAAAAAAAAAAAAAAA
A0000000000000000000000000000000000000000A
A0000000000000000000000000000000000000000A
A000000000000000000000000D000000000000000A
A0000000000000000000000000000000000000000A
A0000000000000000000000000000000000000000A
A0000000000000000000000000000000000000000A
A0000000000000000000000000000000000000000A
A0000000000000000000000000000000000000000A
AJJJJJJJJJJJJJJJJJJJJJJ00000JJJJJJJJJJJJJA
A000000000000000000000J00000JJ000000000000000000A
A00000D000000000000000J00000J0000000000000000000A
A000000000000000000000J00000J0000G00000000000000A
AJJJJJJJJJJJJJ00000000J00000J0000000000000000000A
A000000000000J00000000J00000J000000000000A
A000000000000J00000000J00000JJJJJJJJ00000A
A000000000000J00000000J00000JJJJJJJJ00000A
A00000J000000JJJJJJJJJJ00000JJJJJJJJ00000A
A0000jJ000000000000000000000JJJJJJJJJJJJJA
A00000J0000000000000000000000000000000000A
A000J0J0000000000000000000000000000000000A
A00S00J000000JJJJJJJJJJ000000000000000000A
A0J0j0J000000JJJJJJJJJJ000000000000000000A
AAAAAAAAAAAAAAAAAAAAAAAAAAAAAAAAAAAAAAAAAA