CCCCCCCCCCCCCCCCCCCCCCCCCCCCCCCCCCCCCCCCCC
C0000000000000000000000000000000000000000C
C000000000000000000000000000000000J000000C
C000000J000000000000000000D00000000000000C
C0000000000000000000000000000000000000000C
C0000000000000000000000000000000000000000C
C0000000000000J00000000000000000000000000C
C0000000000000000000000000000000J00000000C
C0000000000000000000000000000000000000000C
CCCCCCCCCCCCCCCCCCCCCCC00000CCCCCCCCCCCCCC
C000000000000000000000C00000CC000000000000000000C
C00000D00000J000000000C00000C000000000J000000000C
C00000000000000000PQ00C00000C0000G00000000000000C
CCCCCCCCCCCCCC0000pq00C00000C000000D000000000000C
C000000000000C00000000C00000C000000000000C
C000000000000C00000000C00000CCCCCCCC00000C
C000000000000C00000000C00000CJJJJJJC00J00C
C00000C000000CCCCCCCCCC00000CJJJJJJC00000C
C0000CC000000000000000000000CCCCCCCCCCCCCC
C00000C000000000000000000000000000000000JC
C000J0C000000000000000000000000000000000JC
C00S00C000000000000000000000000000000000JC
C0J0C0C000000000000000000000000000000000JC
CCCCCCCCCCCCCCCCCCCCCCCCCCCCCCCCCCCCCCCCCC