AAAAAAAAAAAAAAAAAAAAAAAAAAAAAAAAAAAAAAAAAA
A0000000000000000000000000000000000000000A
A0000000000000000000000000000000000000000A
A0000000000000000000000000000000000000000A
A0000000000000000000000000000000000000000A
A0000000000000000000000000000000000000000A
A0000000000000000000000000000000000000000A
A0000000000000000000000000000000000000000A
A0000000000000000000000000000000000000000A
A0000000000000000000000000000000000000000A
A0000000000000000000000000000000000000000A
A0000000000000000000000000000000000000000A
A0000000000000000000000000000000000000000A
AJJJJJJJJJJJJJ000000000000000000000000000A
A000000000000J000000000000000000000000000A
A000000000000J000000000000000000000000000A
A000000000000J000000000000000000000000000A
A00000J000000JJJJJJJJJJ00000JJJJJJJJ00000A
A0000jJ000000000000000000000JJJJJJJJ00000A
A00000J000000000000000000000JJJJJJJJ00000A
A000J0J0000000000000000000000000000000000A
A00S00J000000JJJJJJJJJJ0000000000000G0000A
A0J0j0J000000JJJJJJJJJJ000000000000000000A
AAAAAAAAAAAAAAAAAAAAAAAAAAAAAAAAAAAAAAAAAA