AAAAAAAAAAAAAAAAAAAAAAAAAAAAAAAAAAAAAAAAAAAAAAAAAAAAAAAAAAAAAAAAAAAAAAAAAAAAAAAAAAAAAAAAAAAAAAAAAAAAAAAAAAAAAAAAAAAAAAAAAAAAAAAAAAAAAAAAAAAAAAAAAAAAAAAAAAAAAAAAAAAAAAA
A0000000000A00000000000000000000AAAAAAA00A0000000000000000000000000000000000000000000000000000000000000000000000000000000000000000000000000000000000000000000000000000A
A0000000000A00000000000000000000A00000000A0000000000000000000000000000000000000000000000000000000000000000000000000000000000000000000000000000000000000000000000000000A
A0000000000A00000000000000000000A00000000A0000000000000000000000000000000000000000000000000000000000000000000000000000000000000000000000000000000000000000000000000000A
A0000000000A00000000000000000000A00000000A0000000000000000000000000000000000000000000000000000000000000000000000000000000000000000000000000000000000000000000000000000A
A0000000000A00000000000000000000A00000000A0000000000000000000000000000000000000000000000000000000000000000000000000000000000000000000000000000000000000000000000000000A
A0000000000A00000000000000000000A00000000A0000000000000000000000000000000000000000000000000000000000000000000000000000000000000000000000000000000000000000000000000000A
A0000000000A00000000000000000000A00000000A0000000000000000000000000000000000000000000000000000000000000000000000000000000000000000000000000000000000000000000000000000A
A0000000000A00000000000000000000A00000000A0000000000000000000000000000000000000000000000000000000000000000000000000000000000000000000000000000000000000000000000000000A
A0000000000A00000000000000000000A00000000A0000000000000000000000000000000000000000000000000000000000000000000000000000000000000000000000000000000000000000000000000000A
A0000000000A00000000000000000000A00000000A0000000000000000000000000000000000000000000000000000000000000000000000000000000000000000000000000000000000000000000000000000A
A0000000000A00000000000000000000A00000000A0000000000000000000000000000000000000000000000000000000000000000000000000000000000000000000000000000000000000000000000000000A
A0000000000A00000000000000000000A00000000A0000000000000000000000000000000000000000000000000000000000000000000000000000000000000000000000000000000000000000000000000000A
A0000000000A00000000000000000000A00000000A0000000000000000000000000000000000000000000000000000000000000000000000000000000000000000000000000000000000000000000000000000A
A0000000000A00000000000000000000A00000000A0000000000000000000000000000000000000000000000000000000000000000000000000000000000000000000000000000000000000000000000000000A
A0000000000A00000000000000000000A00000000A0000000000000000000000000000000000000000000000000000000000000000000000000000000000000000000000000000000000000000000000000000A
A0000000000A00000000000000000000A00000000A0000000000000000000000000000000000000000000000000000000000000000000000000000000000000000000000000000000000000000000000000000A
A0000000000A00000000000000000000A00000000A0000000000000000000000000000000000000000000000000000000000000000000000000000000000000000000000000000000000000000000000000000A
A0000000000A00000000000000000000A00000000A0000000000000000000000000000000000000000000000000000000000000000000000000000000000000000000000000000000000000000000000000000A
A0000000000A00000000000000000000A00000000A0000000000000000000000000000000000000000000000000000000000000000000000000000000000000000000000000000000000000000000000000000A
A0000000000A00000000000000000000A00000000A0000000000000000000000000000000000000000000000000000000000000000000000000000000000000000000000000000000000000000000000000000A
A0000000000A00000000000000000000A00000000A0000000000000000000000000000000000000000000000000000000000000000000000000000000000000000000000000000000000000000000000000000A
A0000000000A00000000000000000000A00000000A0000000000000000000000000000000000000000000000000000000000000000000000000000000000000000000000000000000000000000000000000000A
A0000000000A00000000000000000000A00000000A0000000000000000000000000000000000000000000000000000000000000000000000000000000000000000000000000000000000000000000000000000A
A0000000000A00000000000000000000A00000000A0000000000000000000000000000000000000000000000000000000000000000000000000000000000000000000000000000000000000000000000000000A
A0000000000A00000000000000000000A00000000A0000000000000000000000000000000000000000000000000000000000000000000000000000000000000000000000000000000000000000000000000000A
A0000000000A00000000000000000000A00000000A0000000000000000000000000000000000000000000000000000000000000000000000000000000000000000000000000000000000000000000000000000A
A0000000000A00000000000000000000A00000000A0000000000000000000000000000000000000000000000000000000000000000000000000000000000000000000000000000000000000000000000000000A
A0000000000A00000000000000000000A00000000A0000000000000000000000000000000000000000000000000000000000000000000000000000000000000000000000000000000000000000000000000000A
A0000000000A00000000000000000000A00000000A0000000000000000000000000000000000000000000000000000000000000000000000000000000000000000000000000000000000000000000000000000A
A0000000000A00000000000000000000A00000000A0000000000000000000000000000000000000000000000000000000000000000000000000000000000000000000000000000000000000000000000000000A
A0000000000A00000000000000000000A00000000A0000000000000000000000000000000000000000000000000000000000000000000000000000000000000000000000000000000000000000000000000000A
A0000000000A00000000000000000000A00000000A0000000000000000000000000000000000000000000000000000000000000000000000000000000000000000000000000000000000000000000000000000A
A0000000000A00000000000000000000A00000000A0000000000000000000000000000000000000000000000000000000000000000000000000000000000000000000000000000000000000000000000000000A
A0000000000A00000000000000000000A00000000A0000000000000000000000000000000000000000000000000000000000000000000000000000000000000000000000000000000000000000000000000000A
A0000000000A00000000000000000000A00000000A0000000000000000000000000000000000000000000000000000000000000000000000000000000000000000000000000000000000000000000000000000A
A0000000000A00000000000000000000A00000000A0000000000000000000000000000000000000000000000000000000000000000000000000000000000000000000000000000000000000000000000000000A
A0000000000A00000000000000000000A00000000A0000000000000000000000000000000000000000000000000000000000000000000000000000000000000000000000000000000000000000000000000000A
A0000000000A00000000000000000000A00000000A0000000000000000000000000000000000000000000000000000000000000000000000000000000000000000000000000000000000000000000000000000A
A0000000000A00000000000000000000A00000000A0000000000000000000000000000000000000000000000000000000000000000000000000000000000000000000000000000000000000000000000000000A
A0000000000A00000000000000000000A00000000A0000000000000000000000000000000000000000000000000000000000000000000000000000000000000000000000000000000000000000000000000000A
A0000000000A00000000000000000000A00000000A0000000000000000000000000000000000000000000000000000000000000000000000000000000000000000000000000000000000000000000000000000A
A0000000000A00000000000000000000A00000000A0000000000000000000000000000000000000000000000000000000000000000000000000000000000000000000000000000000000000000000000000000A
A0000000000A00000000000000000000A00000000A0000000000000000000000000000000000000000000000000000000000000000000000000000000000000000000000000000000000000000000000000000A
A0000000000A00000000000000000000A00000000A0000000000000000000000000000000000000000000000000000000000000000000000000000000000000000000000000000000000000000000000000000A
A0000000000A00000000000000000000A00000000A0000000000000000000000000000000000000000000000000000000000000000000000000000000000000000000000000000000000000000000000000000A
A0000000000A00000000000000000000A00000000A0000000000000000000000000000000000000000000000000000000000000000000000000000000000000000000000000000000000000000000000000000A
A0000000000A00000000000000000000A00000000A0000000000000000000000000000000000000000000000000000000000000000000000000000000000000000000000000000000000000000000000000000A
A0000000000A00000000000000000000A00000000A0000000000000000000000000000000000000000000000000000000000000000000000000000000000000000000000000000000000000000000000000000A
A0000000000A00000000000000000000A00000000A0000000000000000000000000000000000000000000000000000000000000000000000000000000000000000000000000000000000000000000000000000A
A0000000000A00000000000000000000A00000000A0000000000000000000000000000000000000000000000000000000000000000000000000000000000000000000000000000000000000000000000000000A
A0000000000A00000000000000000000A00000000A0000000000000000000000000000000000000000000000000000000000000000000000000000000000000000000000000000000000000000000000000000A
A0000000000A00000000000000000000A00000000A0000000000000000000000000000000000000000000000000000000000000000000000000000000000000000000000000000000000000000000000000000A
A0000000000A00000000000000000000A00000000A0000000000000000000000000000000000000000000000000000000000000000000000000000000000000000000000000000000000000000000000000000A
A0000000000A00000000000000000000A00000000A0000000000000000000000000000000000000000000000000000000000000000000000000000000000000000000000000000000000000000000000000000A
A0000000000A00000000000000000000A00000000A0000000000000000000000000000000000000000000000000000000000000000000000000000000000000000000000000000000000000000000000000000A
A0000000000A00000000000000000000A00000000A0000000000000000000000000000000000000000000000000000000000000000000000000000000000000000000000000000000000000000000000000000A
A0000000000A00000000000000000000A00000000A0000000000000000000000000000000000000000000000000000000000000000000000000000000000000000000000000000000000000000000000000000A
A0000000000A00000000000000000000A00000000A0000000000000000000000000000000000000000000000000000000000000000000000000000000000000000000000000000000000000000000000000000A
A0000000000A00000000000000000000A00000000A0000000000000000000000000000000000000000000000000000000000000000000000000000000000000000000000000000000000000000000000000000A
A0000000000A00000000000000000000A00000000A0000000000000000000000000000000000000000000000000000000000000000000000000000000000000000000000000000000000000000000000000000A
A0000000000A00000000000000000000A00000000A0000000000000000000000000000000000000000000000000000000000000000000000000000000000000000000000000000000000000000000000000000A
A0000000000A00000000000000000000A00000000A0000000000000000000000000000000000000000000000000000000000000000000000000000000000000000000000000000000000000000000000000000A
A0000000000A00000000000000000000A00000000A0000000000000000000000000000000000000000000000000000000000000000000000000000000000000000000000000000000000000000000000000000A
A0000000000A00000000000000000000A00000000A0000000000000000000000000000000000000000000000000000000000000000000000000000000000000000000000000000000000000000000000000000A
AAAAAAAAAAAAAAAAAAAAAAAAAAAAAAAAAAAAAAAAAAAAAAAAAAAAAAAAAAAAAAAAAAAAAAAAAAAAAAAAAAAAAAAAAAAAAAAAAAAAAAAAAAAAAAAAAAAAAAAAAAAAAAAAAAAAAAAAAAAAAAAAAAAAAAAAAAAAAAAAAAAAAAA
